ğŸŸ¦ ìƒì¡´ì (Survivor)
ê²Œì„ ìœ ë‹›	ëŒ€ì‘ ì´ë¦„
Terran SCV	ìƒì¡´ì - ë°©ê³µí˜¸ ì‹œì„¤ ê´€ë¦¬ì
Terran Wraith	ìƒì¡´ì - ì§
Terran Civilian	ìƒì¡´ì (ëª©ìˆ¨)
Sarah Kerrigan (Ghost)	ìƒì¡´ì - ì• ë‚˜ í´ë¼í¬
Zerg Broodling	ìƒì¡´ì - ë³´íŠ¸ì£¼ì¸
Zerg Overlord	ìƒì¡´ì - ê²½ë¹„ì› C.J
Hunter Killer (Hydralisk)	ìƒì¡´ì - ì¼€ë„¤ìŠ¤ í™€
Protoss Corsair	ìƒì¡´ì - ì…€ë ˆë‚˜
Protoss Probe	ìƒì¡´ì - ë°°ê´€ê³µ
Protoss High Templar	ìƒì¡´ì - í—¬ê¸° ì •ë¹„ì‚¬

ğŸŸ¨ ì‹œë¯¼ / êµ°ì¸ (Civilian / Soldier)
ê²Œì„ ìœ ë‹›	ëŒ€ì‘ ì´ë¦„
Terran Marine	ì‹œë¯¼ - ê²½ì°°
Terran Ghost	ì‹œë¯¼ - íšŒì‚¬ì›
Terran Medic	ì‹œë¯¼ - ì˜ì‚¬
Zerg Hydralisk	ì‹œë¯¼ - ì‚¬ëƒ¥ê¾¼
Zerg Mutalisk	ì‹œë¯¼ - ì´ê¸° ê¸°ìˆ ì
Zerg Devourer	ì‹œë¯¼ - ë²”ì£„ì¡°ì§ ê±°ë¬¼
Protoss Zealot	ì‹œë¯¼ - ê·¼ìœ¡ì§ˆ ì‹œë¯¼
Fenix (Dragoon)	ì‹œë¯¼ - í­ë°œë¬¼ ì „ë¬¸ê°€
Jim Raynor (Marine)	êµ°ì¸ - ì†Œì´ìˆ˜
Firebat	êµ°ì¸ - ì‚°íƒ„ì´ ì‚¬ìˆ˜
Protoss Dragoon	êµ°ì¸ - ì§€ì› í™”ê¸° ì‚¬ìˆ˜
Dark Templar(Hero)	êµ°ì¸ - í­ë™ ì§„ì••ë¶€ëŒ€ì›
Alexei Stukov (Ghost)	êµ°ì¸ - ëŒ€í…ŒëŸ¬ ë¶€ëŒ€ì›
Infested Duran	êµ°ì¸ - ì €ê²©ìˆ˜

ğŸŸ¥ ê°ì—¼ì / ê°ì—¼ì²´ (Infected / Infested)
ê²Œì„ ìœ ë‹›	ëŒ€ì‘ ì´ë¦„
Gui Montag (Firebat)	ê°ì—¼ì - ë¶ˆíƒ€ëŠ” ì‹œë¯¼
Zerg Zergling	ê°ì—¼ì - ë‚œí­í•œ ì‹œë¯¼
Zerg Ultralisk	ê°ì—¼ì - ê±°êµ¬ì˜ ì‹œë¯¼
Zerg Drone	ê°ì—¼ì - ë¶ˆì–´í„°ì§„ ì‹œì²´
Zerg Guardian	ê°ì—¼ì - ë…¹ì•„ë‚´ë¦¬ëŠ” ì‹œì²´
Zerg Queen	ì• ì™„ê²¬ - ì¹©ìŠ¤
Zerg Defiler	ê°ì—¼ì²´ - ì˜¤ì—¼ëœ ì‹œë¯¼
Zerg Scourge	ê°ì—¼ì²´ - ì‹ì¸ êµ¬ë”ê¸°
Torrarsque (Ultralisk)	ê°ì—¼ì²´ - ê´‘ë€ì˜ ëŒ€ì‹ê°€
Infested Terran	ê°ì—¼ì - ë¶€íŒ¨í•œ ì¸ê°„
Infested Kerrigan	ê°ì—¼ì - ë’¤í‹€ë¦° ì¸ê°„
Devouring One (Zergling)	ê°ì—¼ì - ê´‘í¬í•œ ë§ì
Kukulza (Mutalisk)	ê°ì—¼ì²´ - ê¸°ì–´ì˜¤ë¥´ëŠ” ë§ì
Kukulza (Guardian)	ê°ì—¼ì²´ - ê²Œê±¸ìŠ¤ëŸ¬ìš´ í¬ì‹ì
Yggdrasill (Overlord)	ê°ì—¼ì - ìˆ˜ì¥ëœ ì‚¬ëŒë“¤
Protoss Dark Templar(Unit)	ê°ì—¼ì - ê¸°ê´´í•œ ì‹œì²´
Protoss Dark Archon	ê°ì—¼ì - í”¼íˆ¬ì„±ì´ ê±°êµ¬
Tassadar/Zeratul (Archon)	ê°ì—¼ì - ë’¤ì—‰í‚¨ ì‹œì²´
Fenix (Zealot)	ê°ì—¼ì - ì¼ë°˜ ì‹œë¯¼
Tassadar (Templar)	ê°ì—¼ì - ë…¹ì•„ë‚´ë¦° ì–¼êµ´ì˜ ì¸ê°„
Scantid (Desert Critter)	ê°ì—¼ì - ê±°ë¯¸ì¸ê°„
Ragnasaur (Ashworld Critter)	ê°ì—¼ì²´ - ê´´ì´í•œ ì‹œì²´

âš™ï¸ ì˜¤ë¸Œì íŠ¸ ë° ê¸°íƒ€ (Objects / Misc)
ğŸš™ íƒˆ ê²ƒ ë° ìš´ì†¡ìˆ˜ë‹¨
ìœ ë‹›	ì„¤ëª…
Terran Vulture	ë°•ì‚´ë‚œ ì˜¤í† ë°”ì´
Terran Siege Tank (Tank Mode)	ë°•ì‚´ë‚œ ì°¨ëŸ‰
Edmund Duke (Siege Tank)	ê°œì¡°ëœ ìŠ¤ì¿¨ ë²„ìŠ¤
Terran Dropship	êµ°ìš© í—¬ë¦¬ì½¥í„°
Terran Battlecruiser	ë‚¡ì€ ëŒ€í˜• ë³´íŠ¸
Protoss Shuttle	ìˆ˜ë¦¬ëœ í—¬ê¸°
Norad II	ê³ ì¥ë‚œ í—¬ê¸°

ğŸ”« í„°ë ›/í™”ê¸°/ë¬´ê¸°
ìœ ë‹›	ì„¤ëª…
Goliath Turret	SW ENDING
Tank Turret(Tank Mode)	CH ENDING
Edmund Duke Turret	DP ENDING / LIGHT
Tank Turret (Siege Mode)	BT ENDING
Nuclear Missile	minigun overhit

ğŸ¢ ê±´ë¬¼/ì¥ì†Œ
ìœ ë‹›	ì„¤ëª…
Terran Supply Depot	ë¶ˆíƒ€ëŠ” ì”í•´ ë”ë¯¸
Terran Refinery	ì„ ì°©ì¥
Terran Factory	ë¶ˆíƒ€ëŠ” ëŒ€í˜• íŠ¸ëŸ­
Terran Science Facility	ë¶ˆíƒ€ëŠ” ë¯¼ê°€
Terran Physics Lab	ìˆ˜ë™ ê°œí ë°¸ë¸Œ (ë°°ê´€ê³µ í•„ìš”)
Terran Engineering Bay	ë¶ˆíƒ€ëŠ” ì°¨ëŸ‰ ë”ë¯¸
Terran Armory	í•™êµ ì˜¥ìƒë¬¸ (ìƒì¡´ì - ì¼€ë„¤ìŠ¤ í™€ í•„ìš”)
Protoss Nexus	ì² ì¡°ë¬¼ ë°”ë¦¬ì¼€ì´ë“œ
Protoss Gateway	ì½˜í¬ë¦¬íŠ¸ ë°”ë¦¬ì¼€ì´ë“œ
Protoss Forge	ë‚¡ì€ ë°”ë¦¬ì¼€ì´ë“œ
Protoss Cybernetics Core	ë‹¨ë‹¨í•œ ë°”ë¦¬ì¼€ì´ë“œ
Protoss Templar Archives	ì¶•êµ¬ ê³¨ëŒ€
Protoss Observatory	í•©íŒìœ¼ë¡œ ë§ëŒ€ì–´ì§„ ì°½ë¬¸
Protoss Citadel of Adun	ë„ì‹œ ì¡°í˜•ë¬¼
Protoss Arbiter Tribunal	ë°”ë¦¬ì¼€ì´ë“œ
Protoss Fleet Beacon	í•˜ìˆ˜ë„ ì„¤ë¹„ ì¡°ì‘ íŒ¨ë„
Terran Comsat Station	í•˜ìˆ˜ë„ ì´ë²¤íŠ¸ ì‹œì‘í•˜ê¸°

ğŸ§± ìì› ë° ê¸°íƒ€ êµ¬ì¡°ë¬¼
ìœ ë‹›	ì„¤ëª…
Mineral Field (Type 1)	ìë™ì°¨ ì •ë¹„ì†Œ ë¬¸ (ê²½ë¹„ì› C.J í•„ìš”)
Mineral Field (Type 2)	ê²½ì°°ì„œ ë¬¸ (íŠ¹ìˆ˜ë¶€ëŒ€ - Delta force í•„ìš”)
Mineral Field (Type 3)	ì‹ë£Œí’ˆì  ë¬¸ (êµ°ì¸ - ì €ê²©ìˆ˜ í•„ìš”)
Uraj Crystal	ì•„ì´í…œ - í•˜ìˆ˜ë„ ì‹œì„¤ ì •ë¬¸ ì—´ì‡ 
Khalis Crystal	ì•„ì´í…œ - ë¬´ì „ê¸°
Zerg Defiler Mound	ì‹œì²´ì™€ ë’¤ì„ì¸ í‡´ì ë¬¼
Zerg Overmind	ê±°ëŒ€í•œ í•˜ìˆ˜ë„ í‡´ì ë¬¼
Mature Chrysalis	êµ¬ë”ê¸°ê°€ ë“¤ë“ëŠ” ì‹œì²´ ë”ë¯¸
Kyadarin Crystal Formation	ë¬´ë„ˆì§„ ì”í•´ / NIGHT TIME
PSI Disruptor	í•˜ìˆ˜ë„ ì‹œì„¤ ì •ë¬¸ (ì—´ì‡  í•„ìš”)

ğŸ§  íŠ¹ìˆ˜ ìœ ë‹› ë° ê¸°íƒ€
ìœ ë‹›	ì„¤ëª…
Samir Duran (Ghost)	íŠ¹ìˆ˜ë¶€ëŒ€ - S.W.A.T
Zeratul (Dark Templar)	íŠ¹ìˆ˜ë¶€ëŒ€ - Gurkha
Aldaris (Templar)	íŠ¹ìˆ˜ë¶€ëŒ€ - Delta force
Artanis (Scout)	Artanis
Warbringer (Reaver)	Warbringer

ğŸ® ì‹œìŠ¤í…œ / íŠ¸ë¦¬ê±° ê´€ë ¨
ìœ ë‹›	ì„¤ëª…
Map Revealer	wave order
Cave	WAVE SPAWN
Cave-in	heal cool
Cantina	shield regan
Independant Command Center	zombie wave
Independant Starport	normal zombie respawn
Jump Gate	SUN TIME
Ruins	bgm
Disruption Web	minigun cooldown
Terran Marker	minigun on
Protoss Marker	minigun heat
Zerg Marker	DP MOVE
Zerg Beacon	í—¬ê¸° ìˆ˜ë¦¬í•˜ê¸°
Terran Flag Beacon	ë³´íŠ¸ ì‹œë™ê±¸ê¸° (ë³´íŠ¸ì£¼ì¸ í•„ìš”)
Protoss Flag Beacon	ë²„ìŠ¤ íƒ‘ìŠ¹ (ì—ì”¨ë¹„ë¡œ ì´ë™ì‹œ ì „ì²´ ì´ë™)
Zerg Flag Beacon	ë°±í™”ì  ì…êµ¬ (ì—ì”¨ë¹„ë¡œ ì´ë™ì‹œ ì „ì²´ ì´ë™)
Protoss Beacon	í•˜ìˆ˜ë„ ì…êµ¬
Terran Beacon	ì˜¤ë˜ëœ ë°©ê³µí˜¸ ì…êµ¬ (ë¯¸êµ¬í˜„)
Power Generator	í•˜ìˆ˜ë„ ì°½ì‚´ë¬¸
Dark Swarm	manaregen
